10.ox
oo.o..o..o
o....ooo.o
o..oooo.o.
..oo.o..o.
.....ooooo
o.o.o.o.o.
..o.o....o
o.o.o..ooo
ooo.ooo.oo
...oo.o.o.
